111111111111111111111111111111
1010001000100010001000100010E1
1C1010101010101010101010101011
101C10101010101010101010101011
10101C101010101010101010101011
1010101C1010101010101010101011
101010101C10101010101010101011
10101010101C101010101010101011
1010101010101C1010101010101011
101010101010101C10101010101011
10101010101010101C101010101011
1010101010101010101C1010101011
101010101010101010101C10101011
10101010101010101010101C101011
10001000100010P01000100010C011
111111111111111111111111111111