1111111111111
10PC11C00C001
110C111010011
10000000000E1
1111111111111
